rutgers - the state university of new jersey, new brunswick: rutgers - the state university of new jersey, new brunswick
bauman moscow state technical university: bauman moscow state technical university
university of washington: university of washington
brown university: brown university
comenius university in bratislava: comenius university in bratislava
rhodes university: rhodes university
university of bath: university of bath
deakin university: deakin university
university of tasmania: university of tasmania
kyung hee university: kyung hee university
university of virginia: university of virginia
university of pennsylvania: university of pennsylvania
vytautas magnus university: vytautas magnus university
trinity college dublin: trinity college dublin
unict: universitiu degli studi di catania
huazhong university of science and technology: huazhong university of science and technology
the university of western australia: the university of western australia
universidad del valle: universidad del valle
university of tennessee: university of tennessee
universitiat leipzig: universitiat leipzig
iitb: indian institute of technology bombay
georgia tech: georgia institute of technology
aub: american university of beirut
iitg: indian institute of technology guwahati
iitd: indian institute of technology delhi
american university in dubai: american university in dubai
iitk: indian institute of technology kanpur
uitm: universiti teknologi mara
iitm: indian institute of technology madras
iitr: indian institute of technology roorkee
university of utah: university of utah
chung-ang university: chung-ang university
kfupm: king fahd university of petroleum & minerals
kaunas university of technology: kaunas university of technology
shinshu university: shinshu university
virginia commonwealth university: virginia commonwealth university
universitiu di bologna: universitiu di bologna
iacole des ponts paristech: iacole des ponts paristech
universidad simion bolivar venezuela: universidad simion bolivar venezuela
kuwait university: kuwait university
kcl: king's college london
tianjin university: tianjin university
universitas muhammadiyah surakarta: universitas muhammadiyah surakarta
universidad torcuato di tella: universidad torcuato di tella
technische universitiat dortmund: technische universitiat dortmund
university of oklahoma: university of oklahoma
duke university: duke university
university of california, davis: university of california, davis
ateneo de manila university: ateneo de manila university
al azhar university: al azhar university
uwa: the university of western australia
united arab emirates university: united arab emirates university
university at buffalo suny: university at buffalo suny
university of st andrews: university of st andrews
technical university of denmark: technical university of denmark
university of amsterdam: university of amsterdam
australian catholic university: australian catholic university
upm: universiti putra malaysia
colorado state university: colorado state university
beijing university of technology: beijing university of technology
universidade federal de santa maria: universidade federal de santa maria
university of wroclaw: university of wroclaw
dit: dublin institute of technology
west university of timisoara: west university of timisoara
harbin institute of technology: harbin institute of technology
university of macau: university of macau
kit, karlsruher institut fiir technologie: kit, karlsruher institut fiir technologie
leibniz universitiat hannover: leibniz universitiat hannover
university of calgary: university of calgary
purdue university: purdue university
maynooth university: maynooth university
universitia de montriaal: universitia de montriaal
uea: university of east anglia
lappeenranta university of technology: lappeenranta university of technology
nagoya university: nagoya university
universitia toulouse 1, capitole: universitia toulouse 1, capitole
iitkgp: indian institute of technology kharagpur
kanazawa university: kanazawa university
uet: university of engineering & technology
university of guelph: university of guelph
universiti sains malaysia: universiti sains malaysia
princeton university: princeton university
qut: queensland university of technology
university of nebraska: university of nebraska
university of colorado at boulder: university of colorado at boulder
eindhoven university of technology: eindhoven university of technology
university of lausanne: university of lausanne
university of sharjah: university of sharjah
louisiana state university: louisiana state university
universidad autionoma de madrid: universidad autionoma de madrid
universidad carlos iii de madrid: universidad carlos iii de madrid
georgetown university: georgetown university
katholieke universiteit leuven: katholieke universiteit leuven
national taiwan normal university: national taiwan normal university
brigham young university: brigham young university
eotvos lorand university: eotvos lorand university
southeast university: southeast university
fu jen catholic university: fu jen catholic university
istanbul technical university: istanbul technical university
syracuse university: syracuse university
e.a.buketov karaganda state university: e.a.buketov karaganda state university
universitiat frankfurt am main: universitiat frankfurt am main
hse, moscow: national research university higher school of economics
university of plymouth: university of plymouth
ben gurion university of the negev: ben gurion university of the negev
universidad austral: universidad austral
hku: university of hong kong
bogor agricultural university: bogor agricultural university
technische universitiat braunschweig: technische universitiat braunschweig
nagasaki university: nagasaki university
czech technical university in prague: czech technical university in prague
baylor university: baylor university
universitia paul sabatier toulouse iii: universitia paul sabatier toulouse iii
universidad de belgrano: universidad de belgrano
technische universitiat berlin: technische universitiat berlin
indian institute of technology kharagpur: indian institute of technology kharagpur
universitia saint-joseph de beyrouth: universitia saint-joseph de beyrouth
universitiat bayreuth: universitiat bayreuth
ohio university: ohio university
pontificia universidad catiolica argentina santa maria de los buenos aires: pontificia universidad catiolica argentina santa maria de los buenos aires
university of basel: university of basel
kyungpook national university: kyungpook national university
indian institute of technology kanpur: indian institute of technology kanpur
universiti putra malaysia: universiti putra malaysia
universitiu degli studi di torino: universitiu degli studi di torino
bond university: bond university
taras shevchenko national university of kyiv: taras shevchenko national university of kyiv
universitia paris-sorbonne: universitia paris-sorbonne
yokohama national university: yokohama national university
hebrew university of jerusalem: hebrew university of jerusalem
monash university: monash university
virginia polytechnic institute: virginia polytechnic institute
national research saratov state university: national research saratov state university
jcu: james cook university
ipn: instituto politiacnico nacional
newcastle university: newcastle university
brunel university: brunel university
universidad de alcali: universidad de alcali
tilburg university: tilburg university
karl-franzens-universitiat graz: karl-franzens-universitiat graz
universitiu degli studi di catania: universitiu degli studi di catania
universiti malaya: universiti malaya
national sun yat-sen university: national sun yat-sen university
university of zagreb: university of zagreb
universidad nacional de colombia: universidad nacional de colombia
hacettepe university: hacettepe university
peter the great st.petersburg polytechnic university: peter the great st.petersburg polytechnic university
universidad de buenos aires: universidad de buenos aires
ufpr: universidade federal do parani
lincoln university: lincoln university
usm: universiti sains malaysia
ruhr-universitiat bochum: ruhr-universitiat bochum
universidad de guadalajara: universidad de guadalajara
national yang ming university: national yang ming university
yale university: yale university
vanderbilt university: vanderbilt university
university of canberra: university of canberra
universitiat regensburg: universitiat regensburg
usp: universidade de siao paulo
the chinese university of hong kong: the chinese university of hong kong
university of massachusetts, amherst: university of massachusetts, amherst
institut national des sciences appliquiaes de lyon: institut national des sciences appliquiaes de lyon
fordham university: fordham university
paris 2: universitia panthiaon-assas
university of twente: university of twente
universitia nice sophia-antipolis: universitia nice sophia-antipolis
instituto tecnoliogico de buenos aires: instituto tecnoliogico de buenos aires
sumy state university: sumy state university
upmc: universitia pierre et marie curie
saitama university: saitama university
itam: instituto tecnoliogico autonomo de miaxico
university of bahrain: university of bahrain
oregon state university: oregon state university
university of texas dallas: university of texas dallas
queen's university: queen's university
university of kansas: university of kansas
tomsk state university: tomsk state university
university of mississippi: university of mississippi
universitia de strasbourg: universitia de strasbourg
memorial university of newfoundland: memorial university of newfoundland
university of liege: university of liege
universidad tecnoliogica nacional: universidad tecnoliogica nacional
soas - school of oriental and african studies, university of london: soas - school of oriental and african studies, university of london
university of st gallen: university of st gallen
university of colombo: university of colombo
kumamoto university: kumamoto university
university of hertfordshire: university of hertfordshire
universidade de santiago de compostela: universidade de santiago de compostela
national cheng kung university: national cheng kung university
stellenbosch university: stellenbosch university
konkuk university: konkuk university
university of illinois, chicago: university of illinois, chicago
mcmaster university: mcmaster university
ulb: universitia libre de bruxelles
george washington university: george washington university
hong kong: lingnan university
mephi: national research nuclear university mephi
university of science and technology of china: university of science and technology of china
lobachevsky state university of nizhni novgorod: lobachevsky state university of nizhni novgorod
university of szeged: university of szeged
universidad diego portales: universidad diego portales
national tsing hua university: national tsing hua university
universitia paris diderot - paris 7: universitia paris diderot - paris 7
universidad peruana cayetano heredia: universidad peruana cayetano heredia
qatar university: qatar university
justus-liebig-universitiat gieiuen: justus-liebig-universitiat gieiuen
uam: universidad autionoma metropolitana
drexel university: drexel university
queen's university of belfast: queen's university of belfast
chalmers university of technology: chalmers university of technology
university of vermont: university of vermont
oklahoma state university: oklahoma state university
lomonosov moscow state university: lomonosov moscow state university
university of huddersfield: university of huddersfield
nyu: new york university
aston university: aston university
universitia charles-de-gaulle lille 3: universitia charles-de-gaulle lille 3
rmit university: rmit university
london metropolitan university: london metropolitan university
norwegian university of science and technology: norwegian university of science and technology
universitiat stuttgart: universitiat stuttgart
curtin university: curtin university
university of the witwatersrand: university of the witwatersrand
indian institute of technology bombay: indian institute of technology bombay
inha university: inha university
george mason university: george mason university
insa: institut national des sciences appliquiaes de lyon
university of newcastle: university of newcastle
warsaw university of technology: warsaw university of technology
university of maryland, baltimore county: university of maryland, baltimore county
v.n. karazin kharkiv national university: v.n. karazin kharkiv national university
lums: lahore university of management sciences
paris lodron universitiat salzburg: paris lodron universitiat salzburg
australian national university: australian national university
snu: seoul national university
uanl: universidad autionoma de nuevo leion
unito: universitiu degli studi di torino
cuhk: the chinese university of hong kong
al-farabi kazakh national university: al-farabi kazakh national university
universitiat hamburg: universitiat hamburg
florida state university: florida state university
university of ottawa: university of ottawa
leiden university: leiden university
loughborough university: loughborough university
universitat de barcelona: universitat de barcelona
emory university: emory university
st: sofia university st. kliment ohridski
national university of science and technology misis: national university of science and technology misis
rheinische friedrich-wilhelms-universitiat bonn: rheinische friedrich-wilhelms-universitiat bonn
washington state university: washington state university
postech: pohang university of science and technology
universidad de puerto rico: universidad de puerto rico
college of william & mary: college of william & mary
bangor university: bangor university
umeie university: umeie university
university of pittsburgh: university of pittsburgh
university of michigan: university of michigan
lse: london school of economics and political science
university of miami: university of miami
city university of hong kong: city university of hong kong
university of york: university of york
itb: bandung institute of technology
universidad adolfo ibiioez: universidad adolfo ibiioez
universitiat jena: universitiat jena
universiti teknologi petronas: universiti teknologi petronas
makerere university: makerere university
universitia grenoble-alpes: universitia grenoble-alpes
georgia institute of technology: georgia institute of technology
universitia paul-valiary montpellier 3: universitia paul-valiary montpellier 3
universidad de castilla-la mancha: universidad de castilla-la mancha
baku state university: baku state university
university of bradford: university of bradford
uqu: umm al-qura university
university of indonesia: university of indonesia
university of toronto: university of toronto
university of dundee: university of dundee
paris iv: universitia paris-sorbonne
university of cincinnati: university of cincinnati
case western reserve university: case western reserve university
king fahd university of petroleum & minerals: king fahd university of petroleum & minerals
victoria university: victoria university
fia: sofia university st. kliment ohridski
peking university: peking university
university of rochester: university of rochester
universitiat konstanz: universitiat konstanz
university of bergen: university of bergen
abo akademi university: abo akademi university
tomsk polytechnic university: tomsk polytechnic university
national research nuclear university mephi: national research nuclear university mephi
bar-ilan university: bar-ilan university
universidade federal de siao paulo: universidade federal de siao paulo
pontificia universidade catiolica do rio grande do sul: pontificia universidade catiolica do rio grande do sul
the university of sheffield: the university of sheffield
universitia libre de bruxelles: universitia libre de bruxelles
de la salle university: de la salle university
universitiu di pisa: universitiu di pisa
universidad externado de colombia: universidad externado de colombia
universidad de salamanca: universidad de salamanca
aalto university: aalto university
central queensland university: central queensland university
kagoshima university: kagoshima university
shanghai university: shanghai university
universidad de valparaiso: universidad de valparaiso
universidad de palermo: universidad de palermo
macquarie university: macquarie university
vrije universiteit amsterdam: vrije universiteit amsterdam
itesm: tecnoliogico de monterrey
university of notre dame: university of notre dame
university of helsinki: university of helsinki
south china university of technology: south china university of technology
universidad del rosario: universidad del rosario
georgia state university: georgia state university
the university of new south wales: the university of new south wales
national technical university of athens: national technical university of athens
universitia lille 2 droit et santia: universitia lille 2 droit et santia
sabanci university: sabanci university
indian institute of science bangalore: indian institute of science bangalore
cairo university: cairo university
tecnoliogico de monterrey: tecnoliogico de monterrey
aoyama gakuin university: aoyama gakuin university
university of science and technology beijing: university of science and technology beijing
university of chicago: university of chicago
indian institute of technology delhi: indian institute of technology delhi
sun yat-sen university: sun yat-sen university
rensselaer polytechnic institute: rensselaer polytechnic institute
city university of new york: city university of new york
the catholic university of korea: the catholic university of korea
universitiu degli studi di padova: universitiu degli studi di padova
novosibirsk state university: novosibirsk state university
beijing jiaotong university: beijing jiaotong university
city university london: city university london
charles sturt university: charles sturt university
ain shams university: ain shams university
western university: western university
lehigh university: lehigh university
washington university in st. louis: washington university in st. louis
university of tampere: university of tampere
osaka university: osaka university
university of coimbra: university of coimbra
universidad de la repi_blica: universidad de la repi_blica
universidad panamericana: universidad panamericana
universitiat des saarlandes: universitiat des saarlandes
lanzhou university: lanzhou university
abu dhabi university: abu dhabi university
university of florida: university of florida
universidade da coruioa: universidade da coruioa
jagiellonian university: jagiellonian university
universitia de poitiers: universitia de poitiers
yeshiva university: yeshiva university
universidade federal do parani: universidade federal do parani
national chengchi university: national chengchi university
chonnam national university: chonnam national university
university of colorado at denver: university of colorado at denver
university of salford: university of salford
ntu: national taiwan university
university of massachusetts, boston: university of massachusetts, boston
sharif university of technology: sharif university of technology
ecu: edith cowan university
university of santo tomas: university of santo tomas
ritsumeikan university: ritsumeikan university
indian institute of technology guwahati: indian institute of technology guwahati
doshisha university: doshisha university
hokkaido university: hokkaido university
universidad austral de chile: universidad austral de chile
wake forest university: wake forest university
universitia pierre et marie curie: universitia pierre et marie curie
university of leicester: university of leicester
michigan technological university: michigan technological university
iium: international islamic university malaysia
universitiu degli studi di trento: universitiu degli studi di trento
university of ulsan: university of ulsan
university of southern queensland: university of southern queensland
clarkson university: clarkson university
universidad nacional de rosario: universidad nacional de rosario
vrije universiteit brussel: vrije universiteit brussel
university of jyviaskylia: university of jyviaskylia
taipei medical university: taipei medical university
the university of georgia: the university of georgia
universidad nacional de cuyo: universidad nacional de cuyo
american university: american university
ational technical universit: national technical university of ukraine kyiv polytechnic institute
universidad de santiago de chile: universidad de santiago de chile
universitia paris dauphine: universitia paris dauphine
cardiff university: cardiff university
charles university: charles university
university of limerick: university of limerick
universitia de sherbrooke: universitia de sherbrooke
qmul: queen mary university of london
university of dhaka: university of dhaka
la trobe university: la trobe university
university of wollongong: university of wollongong
kobe university: kobe university
chonbuk national university: chonbuk national university
university of the pacific: university of the pacific
university of manitoba: university of manitoba
national university of sciences and technology: national university of sciences and technology
university of pics: university of pics
cukurova university: cukurova university
politecnico di torino: politecnico di torino
moscow institute of physics and technology state university: moscow institute of physics and technology state university
universidade catolica portuguesa, lisboa: universidade catolica portuguesa, lisboa
university of tehran: university of tehran
university of tsukuba: university of tsukuba
university of greenwich: university of greenwich
tallinn university of technology: tallinn university of technology
universitia jean moulin lyon 3: universitia jean moulin lyon 3
lahore university of management sciences: lahore university of management sciences
ukm: universiti kebangsaan malaysia
auckland university of technology: auckland university of technology
the university of warwick: the university of warwick
columbia university: columbia university
ajou university: ajou university
university of turku: university of turku
american university of beirut: american university of beirut
eberhard karls universitiat tiibingen: eberhard karls universitiat tiibingen
university of california, los angeles: university of california, los angeles
kazakh ablai khan university of international relations and world languages: kazakh ablai khan university of international relations and world languages
michigan state university: michigan state university
university of geneva: university of geneva
universitiu cattolica del sacro cuore: universitiu cattolica del sacro cuore
udg: universidad de guadalajara
universidad de montevideo: universidad de montevideo
universitiat diisseldorf: universitiat diisseldorf
national research university higher school of economics: national research university higher school of economics
nanyang technological university: nanyang technological university
universidad de sevilla: universidad de sevilla
universitia catholique de louvain: universitia catholique de louvain
northwestern university: northwestern university
london school of economics and political science: london school of economics and political science
university of zurich: university of zurich
university of seoul: university of seoul
sungkyunkwan university: sungkyunkwan university
instituto tecnoliogico autonomo de miaxico: instituto tecnoliogico autonomo de miaxico
hkust: the hong kong university of science and technology
kth, royal institute of technology: kth, royal institute of technology
manchester metropolitan university: manchester metropolitan university
kazan federal university: kazan federal university
university of oulu: university of oulu
bilkent university: bilkent university
tokyo university of science: tokyo university of science
peopleuas university of china: renmin
bogaziiai iiniversitesi: bogaziiai iiniversitesi
university of minnesota: university of minnesota
universitia de montpellier: universitia de montpellier
pontificia universidad catiolica de chile: pontificia universidad catiolica de chile
university of latvia: university of latvia
simon fraser university: simon fraser university
mcgill university: mcgill university
universitiat bremen: universitiat bremen
stanford university: stanford university
king saud university: king saud university
universidad nacional de la plata: universidad nacional de la plata
anu: australian national university
erasmus university rotterdam: erasmus university rotterdam
dalhousie university: dalhousie university
fudan university: fudan university
university of leeds: university of leeds
moscow engineering physics institute: national research nuclear university mephi
university of san diego: university of san diego
universitat autionoma de barcelona: universitat autionoma de barcelona
university of oxford: university of oxford
delft university of technology: delft university of technology
university of wisconsin-madison: university of wisconsin-madison
sapienza - universitiu di roma: sapienza - universitiu di roma
universidad latinoamericana de ciencia y tecnologia costa rica: universidad latinoamericana de ciencia y tecnologia costa rica
universitiat ulm: universitiat ulm
dartmouth college: dartmouth college
xiamen university: xiamen university
queen mary university of london: queen mary university of london
universidade estadual paulista ji_lio de mesquita filho: universidade estadual paulista ji_lio de mesquita filho
oxford brookes university: oxford brookes university
mit: massachusetts institute of technology
heriot-watt university: heriot-watt university
universidad nacional de tucumin: universidad nacional de tucumin
university of kentucky: university of kentucky
university of lahore: university of lahore
wayne state university: wayne state university
aristotle university of thessaloniki: aristotle university of thessaloniki
seoul national university of science and technology: seoul national university of science and technology
lund university: lund university
kau: king abdul aziz university
universitia du quiabec: universitia du quiabec
birkbeck college, university of london: birkbeck college, university of london
university college cork: university college cork
national taiwan university of science and technology: national taiwan university of science and technology
university of baghdad: university of baghdad
university of southern california: university of southern california
laval university: laval university
universidade federal de viiaosa: universidade federal de viiaosa
gwangju institute of science and technology: gwangju institute of science and technology
universitia claude bernard lyon 1: universitia claude bernard lyon 1
nicolaus copernicus university: nicolaus copernicus university
university of delhi: university of delhi
pennsylvania state university: pennsylvania state university
university of crete: university of crete
universitia panthiaon-assas: universitia panthiaon-assas
universidad de murcia: universidad de murcia
tel aviv university: tel aviv university
palacki university in olomouc: palacki university in olomouc
chungnam national university: chungnam national university
universidade federal do rio grande do sul: universidade federal do rio grande do sul
waseda university: waseda university
radboud university nijmegen: radboud university nijmegen
gifu university: gifu university
amirkabir university of technology: amirkabir university of technology
international islamic university malaysia: international islamic university malaysia
benemiarita universidad autionoma de puebla: benemiarita universidad autionoma de puebla
ens paris: ecole normale supiarieure, paris
uga: universitia grenoble-alpes
udlap: universidad de las amiaricas puebla
universitiu degli studi di napoli federico ii: universitiu degli studi di napoli federico ii
universidade de siao paulo: universidade de siao paulo
universitia paris 1 panthiaon-sorbonne: universitia paris 1 panthiaon-sorbonne
worcester polytechnic institute: worcester polytechnic institute
universidade do estado do rio de janeiro: universidade do estado do rio de janeiro
university of oslo: university of oslo
university of brawijaya: university of brawijaya
goldsmiths, university of london: goldsmiths, university of london
edith cowan university: edith cowan university
shandong university: shandong university
ksu: king saud university
university of east london: university of east london
tongji university: tongji university
university of milano-bicocca: university of milano-bicocca
universitiat rostock: universitiat rostock
university of tulsa: university of tulsa
university of groningen: university of groningen
universidad nacional de ciordoba: universidad nacional de ciordoba
university of lisbon: university of lisbon
universidad del norte: universidad del norte
american university in cairo: american university in cairo
universidade de brasilia: universidade de brasilia
shahid beheshti university tehran: shahid beheshti university tehran
martin-luther-universitiat halle-wittenberg: martin-luther-universitiat halle-wittenberg
beijing institute of technology: beijing institute of technology
universiti teknologi mara: universiti teknologi mara
university of oregon: university of oregon
universitiat kiln: universitiat kiln
aarhus university: aarhus university
iran university of science and technology: iran university of science and technology
universidad nacional de mar del plata: universidad nacional de mar del plata
dankook university: dankook university
universitiat innsbruck: universitiat innsbruck
johannes kepler universitiat linz: johannes kepler universitiat linz
university of the philippines: university of the philippines
al-imam mohamed ibn saud islamic university: al-imam mohamed ibn saud islamic university
renmin: renmin
hitotsubashi university: hitotsubashi university
pontificia universidad javeriana: pontificia universidad javeriana
bandung institute of technology: bandung institute of technology
universidad nacional autionoma de miaxico: universidad nacional autionoma de miaxico
university of pune: university of pune
flinders university: flinders university
illinois institute of technology: illinois institute of technology
university of surrey: university of surrey
sejong university: sejong university
voronezh state university: voronezh state university
ludwig-maximilians-universitiat miinchen: ludwig-maximilians-universitiat miinchen
alexandria university: alexandria university
hanyang university: hanyang university
nanjing university: nanjing university
virginia tech: virginia polytechnic institute
iowa state university: iowa state university
universidad tiacnica federico santa maria: universidad tiacnica federico santa maria
university of bari: university of bari
beijing normal university: beijing normal university
university of johannesburg: university of johannesburg
tokyo university of agriculture and technology: tokyo university of agriculture and technology
nus: national university of singapore
university of kent: university of kent
thammasat university: thammasat university
pontificia universidad catiolica del peri_: pontificia universidad catiolica del peri_
stevens institute of technology: stevens institute of technology
texas a&m university: texas a&m university
universitiat duisburg-essen: universitiat duisburg-essen
durham university: durham university
university of cape town: university of cape town
university of california, san diego: university of california, san diego
technische universitiat darmstadt: technische universitiat darmstadt
chang gung university: chang gung university
tokyo medical and dental university: tokyo medical and dental university
ul: university of limerick
san diego state university: san diego state university
ationa: national university of science and technology misis
julius-maximilians-universitiat wiirzburg: julius-maximilians-universitiat wiirzburg
university of hawaii at muanoa: university of hawaii at muanoa
swansea university: swansea university
ryerson university: ryerson university
brandeis university: brandeis university
universidad de monterrey: universidad de monterrey
university of the western cape: university of the western cape
american university of sharjah: american university of sharjah
universitiu degli studi di pavia: universitiu degli studi di pavia
philipps-universitiat marburg: philipps-universitiat marburg
university of cambridge: university of cambridge
national taipei university of technology: national taipei university of technology
universitat pompeu fabra: universitat pompeu fabra
rutgers - the state university of new jersey, newark: rutgers - the state university of new jersey, newark
universitia paris descartes: universitia paris descartes
university of nairobi: university of nairobi
university of new mexico: university of new mexico
the university of auckland: the university of auckland
tsinghua university: tsinghua university
the university of melbourne: the university of melbourne
arizona state university: arizona state university
university toulouse uo jean jaurios: university toulouse uo jean jaurios
universiti degli studi di roma - tor vergata: universiti degli studi di roma - tor vergata
yamaguchi university: yamaguchi university
universidad de la sabana: universidad de la sabana
uum: universiti utara malaysia
hallym university: hallym university
humboldt-universitiat zu berlin: humboldt-universitiat zu berlin
stockholm university: stockholm university
imperial college london: imperial college london
universidade federal de minas gerais: universidade federal de minas gerais
university of houston: university of houston
hufs uo hankuk: hufs uo hankuk
unisa: university of south australia
dublin institute of technology: dublin institute of technology
universitiat bielefeld: universitiat bielefeld
jilin university: jilin university
unisi: universitiu degli studi di siena
university of patras: university of patras
uts: university of technology, sydney
uia: universidad iberoamericana
universitiu degli studi di genova: universitiu degli studi di genova
ucr: university of california, riverside
university of california, irvine: university of california, irvine
university of karachi: university of karachi
ecole polytechnique fiadiarale de lausanne: ecole polytechnique fiadiarale de lausanne
beihang university: beihang university
royal holloway university of london: royal holloway university of london
aberystwyth university: aberystwyth university
university of ulster: university of ulster
westfialische wilhelms-universitiat miinster: westfialische wilhelms-universitiat miinster
university of victoria: university of victoria
panjab university: panjab university
concordia university: concordia university
ucd: university college dublin
ucc: university college cork
ucb: university of california, berkeley
uca: pontificia universidad catiolica argentina santa maria de los buenos aires
ucm: universidad complutense de madrid
ucl: universitia catholique de louvain
university of california, riverside: university of california, riverside
uci: university of california, irvine
university of debrecen: university of debrecen
university of san francisco: university of san francisco
unifesp: universidade federal de siao paulo
binghamton university suny: binghamton university suny
universidade federal de santa catarina: universidade federal de santa catarina
kaist - korea advanced institute of science and technology: kaist - korea advanced institute of science and technology
university of california, santa barbara: university of california, santa barbara
ucla: university of california, los angeles
northumbria university at newcastle: northumbria university at newcastle
murdoch university: murdoch university
tohoku university: tohoku university
universidad de zaragoza: universidad de zaragoza
clark university: clark university
university of arizona: university of arizona
yeungnam university: yeungnam university
university of stirling: university of stirling
gist: gwangju institute of science and technology
charles darwin university: charles darwin university
eth zurich: eth zurich
universidade estadual de londrina: universidade estadual de londrina
university of california, santa cruz: university of california, santa cruz
puc-sp: pontificia universidade catiolica de siao paulo
rheinisch-westfialische technische hochschule aachen: rheinisch-westfialische technische hochschule aachen
keele university: keele university
lingnan university: lingnan university
university of technology, sydney: university of technology, sydney
james cook university: james cook university
athens university of economics and business: athens university of economics and business
the university of manchester: the university of manchester
universitiu degli studi di modena e reggio emilia: universitiu degli studi di modena e reggio emilia
western sydney university: western sydney university
universitiat erlangen-niirnberg: universitiat erlangen-niirnberg
university of aberdeen: university of aberdeen
miami university: miami university
verona university: verona university
massachusetts institute of technology: massachusetts institute of technology
york university: york university
ecole normale supiarieure de lyon: ecole normale supiarieure de lyon
national chung hsing university: national chung hsing university
alpen-adria-universitiat klagenfurt: alpen-adria-universitiat klagenfurt
keio university: keio university
universitiu degli studi roma tre: universitiu degli studi roma tre
university of eastern finland: university of eastern finland
unifi: universitiu degli studi di firenze
okayama university: okayama university
pontificia universidad catolica del ecuador: pontificia universidad catolica del ecuador
aalborg university: aalborg university
university of new england: university of new england
california institute of technology: california institute of technology
university of birmingham: university of birmingham
university of otago: university of otago
uq: the university of queensland
queensland university of technology: queensland university of technology
ofia university: sofia university st. kliment ohridski
griffith university: griffith university
kasetsart university: kasetsart university
belarus state university: belarus state university
universidade federal da bahia: universidade federal da bahia
university of central florida: university of central florida
universiti utara malaysia: universiti utara malaysia
new jersey institute of technology: new jersey institute of technology
ural federal university: ural federal university
university of ljubljana: university of ljubljana
sultan qaboos university: sultan qaboos university
lancaster university: lancaster university
university of pretoria: university of pretoria
temple university: temple university
universidade federal fluminense: universidade federal fluminense
boston university: boston university
m.o.auezov south kazakhstan state university: m.o.auezov south kazakhstan state university
indian institute of technology madras: indian institute of technology madras
alexandru ioan cuza university: alexandru ioan cuza university
utrecht university: utrecht university
university of illinois at urbana-champaign: university of illinois at urbana-champaign
sogang university: sogang university
zhejiang university: zhejiang university
koia university: koia university
units: universitiu degli studi di trieste
chiba university: chiba university
technion - israel institute of technology: technion - israel institute of technology
ecole normale supiarieure, paris: ecole normale supiarieure, paris
university of reading: university of reading
university of brescia: university of brescia
rudn university: rudn university
universidad de los andes miarida: universidad de los andes miarida
lodz university: lodz university
universitia de lorraine: universitia de lorraine
university at albany suny: university at albany suny
jku: johannes kepler universitiat linz
university of windsor: university of windsor
technische universitiat dresden: technische universitiat dresden
university of hull: university of hull
dublin city university: dublin city university
university of exeter: university of exeter
indiana university bloomington: indiana university bloomington
university of saskatchewan: university of saskatchewan
university of waterloo: university of waterloo
sciences po paris: sciences po paris
yokohama city university: yokohama city university
wuhan university: wuhan university
the university of adelaide: the university of adelaide
singapore management university: singapore management university
linkiping university: linkiping university
moscow state institute of international relations uo mgimo university: moscow state institute of international relations uo mgimo university
boston college: boston college
umm al-qura university: umm al-qura university
national university of singapore: national university of singapore
ulacit: universidad latinoamericana de ciencia y tecnologia costa rica
banaras hindu university: banaras hindu university
kyushu university: kyushu university
university of british columbia: university of british columbia
clemson university: clemson university
new york university: new york university
universitiu ca' foscari venezia: universitiu ca' foscari venezia
tional: national research nuclear university mephi
nuig: national university of ireland, galway
ruprecht-karls-universitiat heidelberg: ruprecht-karls-universitiat heidelberg
universidade estadual de campinas: universidade estadual de campinas
jordan university of science and technology: jordan university of science and technology
rice university: rice university
ucv: universidad central de venezuela
victoria university of wellington: victoria university of wellington
tokyo metropolitan university: tokyo metropolitan university
universidad de navarra: universidad de navarra
universitia de cergy-pontoise: universitia de cergy-pontoise
king abdul aziz university: king abdul aziz university
vilnius university: vilnius university
harvard university: harvard university
ewha womans university: ewha womans university
tcd: trinity college dublin
national university of ireland, galway: national university of ireland, galway
universidad autionoma del estado de miaxico: universidad autionoma del estado de miaxico
university of connecticut: university of connecticut
king's college london: king's college london
universidad metropolitana: universidad metropolitana
seoul national university: seoul national university
east china normal university: east china normal university
university of maryland, college park: university of maryland, college park
arabian gulf university: arabian gulf university
southern federal university: southern federal university
universitat de valencia: universitat de valencia
l.n. gumilyov eurasian national university: l.n. gumilyov eurasian national university
caltech: california institute of technology
university of north carolina, chapel hill: university of north carolina, chapel hill
university of copenhagen: university of copenhagen
universitiat freiburg: universitiat freiburg
university of portsmouth: university of portsmouth
diponegoro university: diponegoro university
university of warsaw: university of warsaw
khazar university: khazar university
universiti kebangsaan malaysia: universiti kebangsaan malaysia
unam: universidad nacional autionoma de miaxico
university of tromso: university of tromso
novosibirsk state technical university: novosibirsk state technical university
airlangga university: airlangga university
universidad nacional costa rica: universidad nacional costa rica
sofia university st. kliment ohridski: sofia university st. kliment ohridski
khon kaen university: khon kaen university
unibo: universitiu di bologna
universidad nacional mayor de san marcos: universidad nacional mayor de san marcos
university of engineering & technology: university of engineering & technology
carleton university: carleton university
university of south australia: university of south australia
national taiwan university: national taiwan university
universidad industrial de santander: universidad industrial de santander
universidade federal do ceari: universidade federal do ceari
utah state university: utah state university
uppsala university: uppsala university
stony brook university: stony brook university
instituto politiacnico nacional: instituto politiacnico nacional
king mongkut's university of technology thonburi: king mongkut's university of technology thonburi
universidad de san francisco de quito: universidad de san francisco de quito
ecole normale supiarieure de cachan: ecole normale supiarieure de cachan
pontificia universidade catiolica do rio de janeiro - puc - rio: pontificia universidade catiolica do rio de janeiro - puc - rio
university of glasgow: university of glasgow
politiacnica de madrid: politiacnica de madrid
university of strathclyde: university of strathclyde
universidade federal do rio de janeiro: universidade federal do rio de janeiro
universidad de la habana: universidad de la habana
the hong kong polytechnic university: the hong kong polytechnic university
indian institute of technology roorkee: indian institute of technology roorkee
ational technical university: national technical university kharkiv polytechnic institute
georg-august-universitiat gittingen: georg-august-universitiat gittingen
kansas state university: kansas state university
gunma university: gunma university
university of missouri, columbia: university of missouri, columbia
university of calcutta: university of calcutta
saint-petersburg state university: saint-petersburg state university
national technical university of ukraine kyiv polytechnic institute: national technical university of ukraine kyiv polytechnic institute
universitiu degli studi di perugia: universitiu degli studi di perugia
khalifa university: khalifa university
massey university: massey university
kent state university: kent state university
vub: vrije universiteit brussel
udelar: universidad de la repi_blica
university of maribor: university of maribor
osaka prefecture university: osaka prefecture university
the university of queensland: the university of queensland
universiti teknologi malaysia: universiti teknologi malaysia
national and kapodistrian university of athens: national and kapodistrian university of athens
qafqaz university: qafqaz university
universidade federal de siao carlos: universidade federal de siao carlos
university of hong kong: university of hong kong
chiang mai university: chiang mai university
university of east anglia: university of east anglia
university of canterbury: university of canterbury
centralesupialec: centralesupialec
university of south florida: university of south florida
mahidol university: mahidol university
pontificia universidad catiolica de valparaiso: pontificia universidad catiolica de valparaiso
universidad de costa rica: universidad de costa rica
korea university: korea university
university of edinburgh: university of edinburgh
plekhanov russian university of economics: plekhanov russian university of economics
technische universitiat miinchen: technische universitiat miinchen
unipv: universitiu degli studi di pavia
universidade federal do pernambuco: universidade federal do pernambuco
niigata university: niigata university
kazakh national pedagogical university abai: kazakh national pedagogical university abai
universitiat mannheim: universitiat mannheim
universidad iberoamericana: universidad iberoamericana
ucsc: university of california, santa cruz
ucsb: university of california, santa barbara
ucsd: university of california, san diego
universitas gadjah mada: universitas gadjah mada
swinburne university of technology: swinburne university of technology
unipd: universitiu degli studi di padova
university of waikato: university of waikato
unicamp: universidade estadual de campinas
tampere university of technology: tampere university of technology
hsg: university of st gallen
howard university: howard university
university of bern: university of bern
ufc: universidade federal do ceari
universidad rey juan carlos: universidad rey juan carlos
king khalid university: king khalid university
unsw: the university of new south wales
missouri university of science and technology: missouri university of science and technology
university of antwerp: university of antwerp
university of mumbai: university of mumbai
epfl: ecole polytechnique fiadiarale de lausanne
dcu: dublin city university
national chiao tung university: national chiao tung university
pusan national university: pusan national university
university of alabama: university of alabama
korea university of foreign studies: hufs uo hankuk
the robert gordon university: the robert gordon university
ochanomizu university: ochanomizu university
donetsk national university: donetsk national university
masaryk university: masaryk university
universitiuae degli studi di palermo: universitiuae degli studi di palermo
universitia lille 1, sciences et technologie: universitia lille 1, sciences et technologie
university of montana missoula: university of montana missoula
universitia paris-sud 11: universitia paris-sud 11
dongguk university: dongguk university
north carolina state university: north carolina state university
new school university: new school university
pohang university of science and technology: pohang university of science and technology
northeastern university: northeastern university
universitia paris ouest nanterre la diafense: universitia paris ouest nanterre la diafense
kazakh-british technical university: kazakh-british technical university
sichuan university: sichuan university
corvinus university of budapest: corvinus university of budapest
usach: universidad de santiago de chile
universidad de chile: universidad de chile
lebanese american university: lebanese american university
christian-albrechts-universitiat zu kiel: christian-albrechts-universitiat zu kiel
prince of songkla university: prince of songkla university
middle east technical university: middle east technical university
university of southampton: university of southampton
yonsei university: yonsei university
universidade nova de lisboa: universidade nova de lisboa
national technical university kharkiv polytechnic institute: national technical university kharkiv polytechnic institute
uerj: universidade do estado do rio de janeiro
ankara iiniversitesi: ankara iiniversitesi
universidad autionoma metropolitana: universidad autionoma metropolitana
universitia de nantes: universitia de nantes
university of iowa: university of iowa
hkbu: hong kong baptist university
carnegie mellon university: carnegie mellon university
ational research nuclear university: national research nuclear university mephi
university of haifa: university of haifa
universitat politiocnica de catalunya: universitat politiocnica de catalunya
middlesex university: middlesex university
hong kong baptist university: hong kong baptist university
university of ghana: university of ghana
the university of tokyo: the university of tokyo
university of new hampshire: university of new hampshire
hiroshima university: hiroshima university
the university of nottingham: the university of nottingham
belarusian national technical university: belarusian national technical university
university of central lancashire: university of central lancashire
petronas: universiti teknologi petronas
university of sussex: university of sussex
university of bucharest: university of bucharest
university of wyoming: university of wyoming
freie universitiat berlin: freie universitiat berlin
universidad de concepciion: universidad de concepciion
university of mons: university of mons
universitiu degli studi di trieste: universitiu degli studi di trieste
universidad nacional del sur: universidad nacional del sur
cornell university: cornell university
university of gothenburg: university of gothenburg
kazakh national technical university after k.i.satpayev: kazakh national technical university after k.i.satpayev
university college dublin: university college dublin
loyola university chicago: loyola university chicago
uic: university of illinois, chicago
budapest university of technology and economics: budapest university of technology and economics
quaid-i-azam university: quaid-i-azam university
kingston university, london: kingston university, london
istanbul university: istanbul university
babes-bolyai university: babes-bolyai university
universitia de caen basse-normandie: universitia de caen basse-normandie
johns hopkins university: johns hopkins university
university of texas at austin: university of texas at austin
university of jordan: university of jordan
marquette university: marquette university
tokyo institute of technology: tokyo institute of technology
universitiu degli studi di ferrara: universitiu degli studi di ferrara
universidad catiolica andrias bello - ucab: universidad catiolica andrias bello - ucab
university of bristol: university of bristol
utn: universidad tecnoliogica nacional
up: universidad panamericana
utm: universiti teknologi malaysia
um: universiti malaya
chulalongkorn university: chulalongkorn university
niversidade estadual pau: universidade estadual paulista ji_lio de mesquita filho
university of delaware: university of delaware
university of california, berkeley: university of california, berkeley
dalian university of technology: dalian university of technology
maastricht university: maastricht university
auburn university: auburn university
ub: universitat de barcelona
johannes gutenberg universitiat mainz: johannes gutenberg universitiat mainz
brno university of technology: brno university of technology
southern methodist university: southern methodist university
universitiu degli studi di milano: universitiu degli studi di milano
gazi iiniversitesi: gazi iiniversitesi
university of south carolina at columbia: university of south carolina at columbia
itba: instituto tecnoliogico de buenos aires
universidad central de venezuela: universidad central de venezuela
the university of sydney: the university of sydney
xi'an jiaotong university: xi'an jiaotong university
osaka city university: osaka city university
university of porto: university of porto
university of southern denmark: university of southern denmark
vilnius gediminas technical university: vilnius gediminas technical university
university of essex: university of essex
sepuluh nopember institute of technology: sepuluh nopember institute of technology
king faisal university: king faisal university
universidad anahuac: universidad anahuac
north-west university: north-west university
east china university of science and technology: east china university of science and technology
universitia de bordeaux: universitia de bordeaux
university of denver: university of denver
nottingham trent university: nottingham trent university
tulane university: tulane university
njit: new jersey institute of technology
universidad autionoma de nuevo leion: universidad autionoma de nuevo leion
universitiat wien: universitiat wien
university of alberta: university of alberta
shanghai jiao tong university: shanghai jiao tong university
coventry university: coventry university
universidad de granada: universidad de granada
university of ghent: university of ghent
pontificia universidade catiolica de siao paulo: pontificia universidade catiolica de siao paulo
tokai university: tokai university
universitia lumiiore lyon 2: universitia lumiiore lyon 2
university of arkansas: university of arkansas
universidad de talca: universidad de talca
universidad politecnica de valencia: universidad politecnica de valencia
universidad de san andrias: universidad de san andrias
universitia aix-marseille: universitia aix-marseille
swiss federal institute of technology: eth zurich
universitiu degli studi di siena: universitiu degli studi di siena
universidad de las amiaricas puebla: universidad de las amiaricas puebla
university of liverpool: university of liverpool
wageningen university: wageningen university
universidad de antioquia: universidad de antioquia
technische universitiat wien: technische universitiat wien
tufts university: tufts university
smith college: smith college
university college london: ucl
university of kufa: university of kufa
ohio state university: ohio state university
national central university: national central university
nust islamabad: national university of sciences and technology
universitia de rennes 1: universitia de rennes 1
university of tartu: university of tartu
politecnico di milano: politecnico di milano
universidad complutense de madrid: universidad complutense de madrid
the hong kong university of science and technology: the hong kong university of science and technology
universitiu degli studi di firenze: universitiu degli studi di firenze
far eastern federal university: far eastern federal university
university of kwazulu-natal: university of kwazulu-natal
university of belgrade: university of belgrade
ecole polytechnique paristech: ecole polytechnique paristech
nankai university: nankai university
universidad de los andes colombia: universidad de los andes colombia
kyoto university: kyoto university